0   2   0   0   2   0   0   0   0   282  282  282    0   0   0   0   0   0   0   0   0   0   0   282  282  282    0   0
282 282 282 0   0   282 282 0   0   0    282   0     282 282 282 282 282 0   0   282 282 0   0   0    282   0     282 282
0   2   0   0   0   0   282 0   0   0    0     2     0   0   0   0   0   0   0   0   282 0   0   0    0     0     0   2
0   0   0   282 282 282 282 282 282 0    2     0     0   2   0   0   0   282 282 282 282 282 282 0    2     0     0   0
2   0   0   0   0   282 0   0   2   0    0     2     0   0   0   0   0   0   0   282  0   0   0  0    2     0     2   0
0   282 282 282 0   282 0   0   0   0    2     0     0   2   0   282 282 282 0   282 0   0   0   0    2     0     0   0
0   0   0   0   0   0   0   2   0   2    0     2     0   2   0   0   0   0   0   0   0   0   0   0    0     2     0   0
2   0   0   2   0   2   0   0   0   2    2     0     0   2   0   0   0   2   0   0   0   2   0   2    0     2     2   0
0   0   0   0   0   0   0   0   0   0    0     0     0   282 0   0   0   0   2   0   0   0   0   0    0     0     0   2
282 282 282 0   0   0   282 282 0   0    0     282   282 0   0   0   0   0   0   0   0   0   0   0    0     0     0   0
0   0   282 0   0   0   0   0   0   0    282   282   282 282 282 282 282 0   0   282 282 0   0   0    282   0     2   282
2   0   282 0   0   2   0   0   0   0    0     282   0   0   282 282 282 0   0   282 282 0   0   0    282   0     0   0
0   2   0   0   0   0   0   0   0   0    0     282   0   0   0   0   0   0   0   0   0   0   282 282  282   2     0   0
0   0   0   282 282 282 0   0   0   0    0     282   282 0   282 282 282 0   0   0   282 282 0   0    0     0     2   0
2   0   0   0   282 0   0   0   282 282  0     282   282 0   282 282 282 0   0   0   282 282 0   0    0     0     0   0
0   0   0   0   0   0   0   0   0   0    0     0     0   0   0   0   0   282 282 0   0   0   0   0    0     0     282 0
282 282 282 0   2   0   282 282 0   0    0     0     0   0   0   0   0   0   0   0   0   0   0   282  282  282    0   0
0   0   0   0   2   0   0   282 282 282  0     0    282  282 0   282 0   282 0   282 282 0   0   0    0     0     0   282
0   0   0   0   2   0   0   0   0   282  0     0    282  0   0   0   0   0   0   0   0   0   282 282  282   0     0   0
0   2   0   0   2   0   2   0   0   0    0     0    282  0   0   0   0   0   0   0   0   0   282 282  282   0     2   0
2   0   0   282 0   0   0   0   0   0    0     0     0   0   282 282 282 0   0   0   282 282 0   0    0     2     0   0
0   0   0   282 0   0   0   282 282 0    0     0     0   0   0   2   0   0   0   0   0   0   0   0    0     0     0   282
2   282 0   282 0   282 282 0   0   0    0     0     0   282 0   0   0   0   2   2   2   0   0   0    0     2     2   0
0   0   0   282 0   0   282 0   0   0   282   282   282  282 0   0   0   2   2   0   0   0   0   0    0     2     0   0
0   2   0   0   0   0   0   0   2   0    0     0     0   0   0   0   0   0   0   0   0   0   0   0    0     0     0   0
2   0   0   0   0   2   0   0   0   0    0     0     0   0   282 282 282 0   0   0   282 282 0   0    0     282   282 0
0   0   0   282 282 0   0   2   0   0    0     0     282 0   282 282 0   0   0   0   0   0   0   282  282   282   282 0
0   2   0   2   0   0   2   0   282 282  282   0     0   0   282 282 0   0   2   0   0   0   0   282  282   282   0   0

