204  0   0   2   0   0   2   2   2   204  204   204   0   2   0    2
204  204 204 0   0   204 204 0   0   0    204   0     204 0   204  0
204  0   2   0   0   2   0   0   0   0    0     0     204 0   204  0
204  0   0   204 0   0   0   2   0   2    0     2     204 0   0    0
0    204 0   0   0   0   0   0   0   0    0     0     0   0   204  0
0    0   0   0   0   204 0   2   0   0    0     204   0   0   0    2
0    2   0   204 204 0   0   0   2   0    204   0     204 0   0    2
2    0   204 204 0   0   0   2   0   2    204   2     204 0   0    0
0    0   2   0   2   0   0   0   2   0    204   0     0   0   0    204
2    204 0   0   0   204 0   0   2   0    204   0     0   0   204  0
0    204 0   2   0   204 0   0   0   0    0     0     204 204 0    0
0    0   2   0   0   204 204 0   2   0    0     204   204 0   204  0
204  0   0   0   0   0   0   2   0   2    0     0     2   0   0    2
0    2   2   204 204 204 0   0   0   0    0     2     204 0   204  0
0    0   2   204  0  0   2   0   204 204  204   0     0   0   0    0
204  0   0   204  0  2   0   0   2   0    0     0     0   2   2    2

