0   1   1   23  23  23  23  0   0   23  23   23   0   0  0  1
0   0   23  23  0   0   0   0   0   0   0    0    23  23 0  0
0   0   23  0   0   2   2   23  0   0   23   23   23  23 0  0
23  23  23  0   0   23  0   1   1   0   0    2    0   0  1  1
2   0   0   0   1   0   0   0   0   0   1    0    1   0  0  0
0   0   23  0   0   23  2   0   23  0   23   23   23  0  2  0
2   0   23  0   0   23  0   0   1   1   0    0    0   0  0  23
0   23  23  23  0   23  23  0   2   0   2    23   23  23 0  23
0   0   0   0   0   23  0   0   0   2   0    0    0   0  0  23
1   23  0   1   0   23 23   23  0   0   23   23   23  0  0  0
2   0   1   0   1   0   0   0   0   0   0    0    23  23 0  0
1   0   0   23  23  0   23  23  0   2   0    2    0   0  23 0
0   1   0   0   1   0   1   0   0   0   1    0    0   0  23 0
23  0   0   23  0   23  23  0   0   0   0    0    23  0  23 1
23  0   2   0   23  0   0   0   23  23  0    2    0   0  0  0
0   1   0   1   0   0   2   0   0   0   0    0    23  23 0  1

